
EA ./textures/N2.xpm
NO ./textures/N2.xpm
SO ./textures/N2.xpm
WE ./textures/N2.xpm

F 100,149,237
C 255,228,181

1111111111111
10000000000001
111110000S0001
11111000000001
11111000000001
11110000000001
11110000000001
11110000000001
11110000000001
11110000000001
11110000000001
11110000010001
11110000000101
11110000000001
11110000000001
11110000000001
11110000000001
11110000000001
11111000000001
11111000000001
111111111111111111
