1111111111111111111111111
1000000000000000000000001
1000000000000000000000001
1000000000000000000000001
1000001111111111110000001
1000000000000000000000001
1000000000000000000000001
1000000000000000000000001
1000000000N00000000000001
1000000000000000000000001
1000001000000000000000001
1000000000000000000000001
1000011100000000001000001
1000000000000000001000001
1000000000100000001000001
1000000000100000001000001
1000000000100000001000001
1000000000100000000000001
1000000000100000000000001
1000000000100000000000001
1000000000000000000000001
1111111111111111111111111