
EA ./textures/W1.xpm
NO ./textures/W1.xpm
SO ./textures/W1.xpm
WE ./textures/W1.xpm

F 100,149,237
C 255,228,181

1111111111111
11111111111111
111110000E0001
11111000000001
11111000001001
11110000000001
11110000000001
11110000000001
11110000000001
11110000000001
11110000000001
11110000010001
11110000000101
11110000000001
11110000000001
11110000000001
11110000000001
11110000000001
11111000000001
11111000000001
111111111111111111
