EA ./textures/E0.xpm
NO ./textures/E.xpm
SO ./textures/E.xpm
WE ./textures/E0.xpm

F 100,149,237
C 255,228,181


   1
 11111
100N011
 100101
  1011
   11
