

NO ./textures/NO.xpm
SO ./textures/NO.xpm
WE ./textures/NO.xpm
EA ./textures/NO.xpm

F 153,102,51
C 163,208,230




1111111111111
10000000000001
111110000S0001
11111000000001
11111000000001
11111000000001
11111000000001
11111000000001
11111000000001
11111000000001
11111000000001
11111000000001
11111000000001
11111000000001
11111000000001
11111000000001
11111000000001
11111000000001
11111000000001
11111000000001
111111111111111111