
EA ./textures/S0.xpm
NO ./textures/S0.xpm
SO ./textures/S0.xpm
WE ./textures/S0.xpm
F 100,149,237
C 255,228,181
1111111111111
11111111111111
1111100000001
11111000E00001
11111000001001
11110000000001
11110000000001
11110000000001
11110000000001
11110000000001
11110000000001
11110000010001
11110000000101
11110000000001
11110000000001
11110000000001
11110000000001
11110000000001
11111000000001
11111000000001
111111111111111111
