

NO ./textures/NO.xpm
SO ./textures/SO.xpm
WE ./textures/SO.xpm
EA ./textures/NO.xpm

F 153,102,51
C 163,208,230




1111111111111
10000000000001
1000000000001
10000000N001
1111111111111