EA ./textures/E4.xpm
NO ./textures/N4.xpm
SO ./textures/N4.xpm
WE ./textures/E4.xpm

F 100,149,237
C 255,228,181

1111111111111
11111111111111111111111111111111111
11111000000000000000000111111
11111000N0000000000000000001111
1111111110000000000000000000001111111111111111111111
11111111111111000000000000000000000000000011111111
11111111111111111111111111111111111111110000000001
11111111111111000000000000000000000000000000111111111
10000000000000000000000000000000000000000000000011
1000000000000000000000000000000000000000000010001
111111111111111111111111111111111111111111111111
