EA ./textures/E0.xpm
NO ./textures/E.xpm
SO ./textures/E.xpm
WE ./textures/E0.xpm

F 100,149,237
C 255,228,181


1111111111111
11111111111111111111111111111111111
11111000N00000000000000111111
111110000010000000000000000111
1111111110000000000000000000001111111111111111111111
1111111111111100000000000000000000000000011111111
11111111111111111111111111111111111111110000000001
11111111111111000000000000000000000000000000111111111
10000000000000000000000000000000000000000000000011
1000000000000000000000000000000000000000000010001
111111111111111111111111111111111111111111111111
111111111111111111111111111111111111111111111111
