EA ./textures/E0.xpm
NO ./textures/E.xpm
SO ./textures/E.xpm
WE ./textures/E0.xpm

F 100,149,237
C 255,228,181


11111111
11100111
1100N011
10000001
10011101
11110001
11111001
11111111 
