


SO ./textures/wall.xpm
NO ./textures/wall.xpm

WE ./textures/wall.xpm
EA ./textures/wall.xpm
F 77,92,53
C 163,208,230




        1111111111111111111111111
        1000000000110000000000001
        1011000001110000000000001
        100100000000000W000000001
111111111011000001110000000000001
111111111111111111111111111111111
