11111111111111
10000000001101
10000000000001
11111111111111
