11111111111111111
10000000000001001
1000000N000001001
10000000000001001
11111000000001001
10000000000000001
10000000000000001
10000001111110001
10000001000000001
10000001000000001
11111111111111111
