11111111111111111
10000000000001001
10000000000001001
10000000000001001
111110000E0001001
10000000000000001
10000000000000001
10000001111110001
10000001000000001
10000001000000001
11111111111111111
