NO ./textures/W1.xpm
SO ./textures/E.xpm
WE ./textures/N4.xpm
EA ./textures/W1.xpm

F 153,102,51
C 163,208,230




111111111111111111111
100000000000000000001
100000001000000000001
10000001N100000000001
100000001000000000001
100000000000000000001
111111111111111111111
