NO ./textures/W1.xpm
SO ./textures/W1.xpm
WE ./textures/W1.xpm
EA ./textures/W1.xpm

F 153,102,51
C 163,208,230




1111111111111
111110000S0001
11111000000001
111111111111111111
